1111111111111
10F10000000C1
1000011111001
1P0C11E0000F1
1111111111111