1111111111111
10010000000C1
1000011111001
1P0011E000PF1
1000000000001
1000000101011
10010000000C1
1000011111001
1P0011E000PF1
1111111111111